
    ##############
    #v<<<<<<<<<<<#
 ####v##########^#
 #>k>v<k<<<<<<<#^#
 #^##t########^#^#
 #^#    #  _ f^#^#
 #^# x? #W # f^#^#
 #^#    #  # f^#^#
 #^#   c#c # f^#^#
 #^#############^#
 #^w # c#c ###>>^#
 #^w #  #  ho#^###
 #^w # F#t####^#
 #^w _  #   k ^#
 ###############