#######################
#######################
##:::::::::::::::::::##
##::ddddddddddddddd::##
##::ddddddddddddddd::##
##::dd           dd::##
##::dd           dd::##
##::dd           dd::##
##?:dd           dd::###
#x::dd   z k     dd::ho#
##::dd           dd::###
##::dd           dd::##
##::dd           dd::##
##::dd           dd::##
##::dd           dd::##
##::ddddddddddddddd::##
##::ddddddddddddddd::##
##:::::::::::::::::::##
#######################
#######################
