#############################
#  u  u  u  u  u  u  u  u ###
#1u    zzzz           #   u##
#   #                 #     ##
#1u #     ###     #   #     u##
#   ####### #######   #
#3u 3u3u   3u 3u 3u 3u3u 
#////// 3u ////////////
#1u u //////u  u   u u2
#      2u  2u 
#                      x
#1u     ///////
#       ##
#1u3u 3u#
#:::::###