    ###               
   ##R##########      
 ###A  #  !#   #      
 #oE : h   # x #      
 ###   #   #   ###### 
   ## ######        # 
 ###   w   :      mb# 
 #Fr   w   :    *#####
 ###########*    #B#k#
           #    *: ff#
           ###########
