
    ###
#####R##########
#oQE   #  !#   #
#### : h   # x #
   #  A#   #   ######
   ## ######        #
 ###   w   :      mb#
 #Fr   w   :*    #####
 ###########    *#B#k#
           #*    : ff#
           ###########