    ###
### #W# ###
#k###h###k#
# #     # #
# #  u  # #
#   u#u u #
# #######u#
#    #    #
# #     # #
# #  x  # #
# ###w### #
#k# #w# #k#
### # # ###
    #o#
    ###