   ########
   #  #   #
   #  m   #   ###
   #  ##m###### ###
   # ###       Tho#
####m###  # x #####
#>>>   ####     F#
#^##m#      #v#T #
#^#  ########v####
#^#   wwww W#v#
#^###########v###
#^<<<<<_  _  v# #
######^#w####v#.#
     #^#w#  #v# #
     #^#w#k  v# #
     #^#w# . v#A#
    ##^#w####v# #
  ###>^#w#  #v# #
  #k ^##w##  v###
  ###^#   #k v#
  #kf^# k ###v#
  ###^#   #v<<#
  #k ^#####v###
  ###^<<<<<<#
    #########
