       ###
       #o#
   #####h####
   #v<<<<<<<#
   #v######^#
####v#wwww#^####
#v<<<#wIkw#^<<<#
#v####wwww####^#
#v#iii    fff#^#
#v#iF#  ? fVf#^#
#v#ik#  W fkf#^#
#v#iii  x fff#^#
#v####    ####^#
#>>>>>^^^>>>>>^#
######^k^^######
     #^^^^#
     ######