=================
=               =
=               =
==-==-#####-=====
=k X  =   =  / k=
=k X  = ? -  / k=
=k X  - x =  / k=
=k X  =   =  / k=
======##h##======
       #o#
       ###