  #######
  #  k  #
  #     #
  #  #  ###########
###  #u   ww     k#
#oh  ##u  ww mmx? #
###  #u   ww     k#
  #  #  ###########
  #     #
  #  k  #
  #######