#########
##  T  k##############
#. # ####      #  e  #
##     ###h##o #  # k#
###### .#   #### !####
##  T  ## x #  E  #  #
#. # #### ? #  #  E k#
##            !#######
########### #  #  E k#
    #       #  e  #  #
    # k k ###### !####
    #  k  #    #  #  #
    # k k #    #  e k#
    #     #    #######
    #######