################################
#     h                        #
# ##### ##############v####### #
# ####   ##                  # #
# ###     ##    ##           # #
#o##       ##   ##########v# # #
###         ##        m  # # # #
##           ##          # # # #
#             ############ # # #
#
#
##
###
#k##
#  ##
#   ##
#   k##Q#
## #### #
##   ##Q#
#     # #
#     #Q#
#